NO /home/luised94/Cub3d/imgs/a.xml
SO /home/luised94/Cub3d/imgs/b.xml
WE /home/luised94/Cub3d/imgs/c.xml
EA /home/luised94/Cub3d/imgs/d.xml
F 220,100,0
C 225,30,0

111111
101001
1011101
101 101
1111112
10N0001
1111111
