NO /home/luised94/Cub3d/imgs/north.xpm
SO /home/luised94/Cub3d/imgs/south.xpm
WE /home/luised94/Cub3d/imgs/west.xpm
EA /home/luised94/Cub3d/imgs/east.xpm
F 220,100,0
C 225,30,0

11111111111
10000000001
10000000001111111111111111
1100000000000000000000000011111
1100N100000000000000000000000021
111111111111111111111111111111
