NO ./imgs/a.xml
SO ./imgs/b.xml
WE ./imgs/c.xml
EA ./imgs/d.xml
F 220,100,0
C 225,30,0

111111
101001
1011101
101 101
1010001
10N001
111111
