NO /Users/lsoto-do/core04/Cub3d/imgs/a.xml
SO /Users/lsoto-do/core04/Cub3d/imgs/b.xml
WE /Users/lsoto-do/core04/Cub3d/imgs/c.xml
EA /Users/lsoto-do/core04/Cub3d/imgs/d.xml
F 220,100,0
C 225,30,0

111111
100101
101001
110EN1
111111
