NO ./imgs/north.xpm
SO ./imgs/south.xpm
WE ./imgs/west.xpm
EA ./imgs/east.xpm
F 220,100,0
C 225,30,0

11111111
1001000001
101001111
1100N1
111111
