NO ./imgs/a.xml
SO ./imgs/b.xml
WE ./imgs/c.xml
EA ./imgs/d.xml
F 220,100,0
C 225,30,0

11111111111
10000000001
10000000001111111111111111
1100000000000000000000000011111
1100N100000000000000000000000001
111111111111111111111111111111
