NO ./imgs/north.xpm
SO ./imgs/south.xpm
WE ./imgs/west.xpm
EA ./imgs/east.xpm
F 220,100,0
C 225,30,0

1111N11
100101
101001
110001
111111