NO ./imgs/north.xpm
SO ./imgs/south.xpm
WE ./imgs/west.xpm
EA ./imgs/east.xpm
F 220,100,0
C 225,30,0

111111
100001
101N001
101 101
111 111