NO /home/luised94/Cub3d/imgs/north.xpm
SO /home/luised94/Cub3d/imgs/south.xpm
WE /home/luised94/Cub3d/imgs/west.xpm
EA /home/luised94/Cub3d/imgs/east.xpm
F 220,100,0
C 225,30,0

1111111111111
1010000000001
101110111111
101 101
1011001
1N0001
111111
