NO /home/luised94/Cub3d/imgs/a.xml
SO /home/luised94/Cub3d/imgs/b.xml
WE /home/luised94/Cub3d/imgs/c.xml
EA /home/luised94/Cub3d/imgs/d.xml
F 220,100,0
C 225,30,0

1111111111111
1010000000001
101110111111
101 101
1011001
10N001
111111
