NO /home/luised94/Cub3d/imgs/north.xpm
SO /home/luised94/Cub3d/imgs/south.xpm
WE /home/luised94/Cub3d/imgs/west.xpm
EA /home/luised94/Cub3d/imgs/east.xpm
F 220,100,0
C 225,30,0

111111
10N001
1011001
101 101
111 111