NO /home/luised94/Cub3d/imgs/north.xpm
SO /home/luised94/Cub3d/imgs/south.xpm
WE /home/luised94/Cub3d/imgs/west.xpm
EA /home/luised94/Cub3d/imgs/east.xpm
F 220,100,0
C 225,30,0

11111
10001
10001
1000111111111111111111111111111
10000100000000000000000000000011111
1100020000000000000000000000001
100N111111111111111111111111111
11211
10001
10001
10001
10001
10001
10001
10001
10001
10001
10001
10001
10001
10001
11111