NO ./imgs/north.xpm
SO ./imgs/south.xpm
WE ./imgs/west.xpm
EA ./imgs/east.xpm
F 100, 125, 135
C 109,164,170

11111
10001
10N01
10001
11111