NO /Users/lsoto-do/core04/Cub3d/imgs/north.xpm
SO /Users/lsoto-do/core04/Cub3d/imgs/south.xpm
WE /Users/lsoto-do/core04/Cub3d/imgs/west.xpm
EA /Users/lsoto-do/core04/Cub3d/imgs/east.xpm
F 100, 125, 135
C 109,164,170

11111111
10001001
10N02001
10001001
11111111