NO ./imgs/north.xpm
SO ./imgs/south.xpm
WE ./imgs/west.xpm
EA ./imgs/east.xpm
F 204, 235, 52
C 225,30,0

11111
10001
1N001
10001
11111