NO /Users/lsoto-do/core04/Cub3d/imgs/north.xpm
SO /Users/lsoto-do/core04/Cub3d/imgs/south.xpm
WE /Users/lsoto-do/core04/Cub3d/imgs/west.xpm
EA /Users/lsoto-do/core04/Cub3d/imgs/east.xpm
F 220,100,0
C 225,30,0

11111
10001
10001
1000111111111111111111111111111
1E000100000000000000000000000011111
1100000000000000000000000000001
1000111111111111111111111111111
10011
10001
10001
10001
10001
10001
10001
10001
11111